XXXXXXXXXXXXXXX
X..$$$$$$$$$..X
X..$.......$..X
X..$.......$..X
X..$.......$..X
X..$$$$$$$$$..X
X...TTTTTTT...X
X....TTTTT....X
X.....TTT.....X
X......T......X
XXXXXXXXXXXXXXX
